BMAPBOLOr^€2М^€2МЮ€2rЮ€2Ъ]€2d]€2dЯ€2ЪЯ€2ГШ€2{Ш€2Гd€2{d€2|~€2В~€2o€2Н€2О€ZZZn€ZZZНv€ZZZqv€ZZZqЖ€ZZZНЖ€ZZZqj€ZZZНj€ZZZqТ€ZZZНТ€ZZZЧ€ZZZe€ZZZeЙ€ZZZes€ZZZЩs€ZZZЩЙ€ZZZdxoxoДdДПxЪxЪДПДf}f
m}mС}С
Ш}Ш"

циииииииииииииииииииииииииииии®"
циииииииииииииииииииииииииииии®"
циииииииииииииииииииииииииииии®"
циииииииииииииииииииииииииииии®"
циииииииииииииииииииииииииииии®"
циииииииииииииииииииииииииииии®"
циииииииииииииииииииииииииииии®"
циииииииииииииииииииииииииииии®"
циииииииииииииииииииииииииииии®"
циииииииииииииииииииииииииииии®"
циииииииииииииииииииииииииииии®"
циииииииииииииииииииииииииииии®"
циииииииииииииииииииииииииииии®"
циииииииииииииииииииииииииииии®"
циииииииииииииииииииииииииииии®"
циииииииииииииииииииииииииииии®"
циииииииииииииииииииииииииииии®"
циииииииииииииииииииииииииииии®"
циииииииииииииииииииииииииииии®"
циииииииииииииииииииииииииииии®"
циииииииииииииииииииииииииииии®"
циииииииииииииииииииииииииииии®" 
циииииииииииииииииииииииииииии®"!
циииииииииииииииииииииииииииии®""
циииииииииииииииииииииииииииии®"#
циииииииииииииииииииииииииииии®"$
циииииииииииииииииииииииииииии®"%
циииииииииииииииииииииииииииии®"&
циииииииииииииииииииииииииииии®"'
циииииииииииииииииииииииииииии®"(
циииииииииииииииииииииииииииии®")
циииииииииииииииииииииииииииии®"*
циииииииииииииииииииииииииииии®"+
циииииииииииииииииииииииииииии®",
циииииииииииииииииииииииииииии®"-
циииииииииииииииииииииииииииии®".
циииииииииииииииииииииииииииии®"/
циииииииииииииииииииииииииииии®"0
циииииииииииииииииииииииииииии®"1
циииииииииииииииииииииииииииии®"2
циииииииииииииииииииииииииииии®"3
циииииииииииииииииииииииииииии®"4
циииииииииииииииииииииииииииии®"5
циииииииииииииииииииииииииииии®"6
циииииииииииииииииииииииииииии®"7
циииииииииииииииииииииииииииии®"8
циииииииииииииииииииииииииииии®"9
циииииииииииииииииииииииииииии®":
циииииииииииииииииииииииииииии®";
циииииииииииииииииииииииииииии®"<
циииииииииииииииииииииииииииии®"=
циииииииииииииииииииииииииииии®">
циииииииииииииииииииииииииииии®"?
циииииииииииииииииииииииииииии®"@
циииииииииииииииииииииииииииии®"A
циииииииииииииииииииииииииииии®"B
циииииииииииииииииииииииииииии®"C
циииииииииииииииииииииииииииии®"D
циииииииииииииииииииииииииииии®"E
циииииииииииииииииииииииииииии®"F
циииииииииииииииииииииииииииии®"G
циииииииииииииииииииииииииииии®"H
циииииииииииииииииииииииииииии®"I
циииииииииииииииииииииииииииии®"J
циииииииииииииииииииииииииииии®"K
циииииииииииииииииииииииииииии®"L
циииииииииииииииииииииииииииии®"M
циииииииииииииииииииииииииииии®"N
циииииииииииииииииииииииииииии®"O
циииииииииииииииииииииииииииии®"P
циииииииииииииииииииииииииииии®"Q
циииииииииииииииииииииииииииии®"R
циииииииииииииииииииииииииииии®"S
циииииииииииииииииииииииииииии®"T
циииииииииииииииииииииииииииии®"U
циииииииииииииииииииииииииииии®"V
циииииииииииииииииииииииииииии®"W
циииииииииииииииииииииииииииии®"X
циииииииииииииииииииииииииииии®"Y
циииииииииииииииииииииииииииии®"Z
циииииииииииииииииииииииииииии®"[
циииииииииииииииииииииииииииии®"\
циииииииииииииииииииииииииииии®$]
цииииииииииЎХдƒеееХдƒХиииииииииии%^
цииииииииииЎ•дƒеееNKJ^ООООООООООА%_
цииииииииииЎ•дƒеееNKJ^ООООООООООА#`
цииииииииииЎµдƒее’дƒµиииииииииии#a
цииииииииииЎµд‘ееµд‘µиииииииииии$b
цииииииииииЎ’д‘ееNLM^ООООООООООА%c
цииииииииииЎ’дд^Z^NAE≈иииииииииии#d
цииииииииииЎеддФ’ддФеиииииииииии%e
цииииииииииЎеNNNNNHNQXииииииииииЎ%f
цииииииииииЎеЕддддд^QXииииииииииЎ#g
цииииииииииЎеµддддФеµиииииииииии$h
цииииииииииЎе≈дддд^[^ООООООООООА"i
цииииииииииЎе’ддд‘е’иииииииииии"j
цииииииииииЎеедддіееиииииииииии#k
цииииииииииЎеµддддФеµиииииииииии#l
цииииииииииЎе•ддддіе•иииииииииии%m
цииииииииииЎеNNNNNHNQXииииииииииЎ"n
цииииииииииЎедддддіеиииииииииии#o
цииииииииииЎ’ддіЈдді’иииииииииии#p
цииииииииииЎ≈дд»Ј»дд≈иииииииииии#q
цииииииииииЎµддЎЈЎддµиииииииииии&r
цииииииииииЎµдƒиz~БДдіµиииииииииии&s
цииииииииииЎ•д‘иz~БДдƒ•иииииииииии't
цииииииииииЎ•дƒОЛ~ВЗNKJ^ООООООООООА)u
цииииииииииЎЕд‘Зиz~БЗNLH^ООООООООООА)v
цииииииииииЎЕд‘Зиz~БЗNLH^ООООООООООА(w
цииииииииииЎЕбЅЧиz~БЗЗбЅЕиииииииииииx
dииииииииииЎЕxpПx~БЗІиxpxЫцQXииииииииииЎy
dииииииииииЎЕypПx~БЗІиxpyЫцQXииииииииииЎz
dииииииииииЎЕzpПx~БЗІиxpzЫцQXииииииииииЎ{
dииииииииииЎЕ{pПx~БЗІиxp{ЫцQXииииииииииЎ|
dииииииииииЎЕ|pП~~~zp|ЫцQXииииииииииЎ}
dииииииииииЎЕ}pП~~~zp}ЫцQXииииииииииЎ~
dииииииииииЎЕ~pП~~~zp~ЫцQXииииииииииЎ
dииииииииииЎЕpП~~~zpЫцQXииииииииииЎА
dииииииииииЎЕАpП~~~zpАЫцQXииииииииииЎБ
dииииииииииЎЕБpПx~БЗІиxpБЫцQXииииииииииЎВ
dииииииииииЎЕВpПx~БЗІиxpВЫцQXииииииииииЎГ
dииииииииииЎЕГpПx~БЗІиxpГЫцQXииииииииииЎД
dииииииииииЎЕДpПx~БЗІиxpДЫцQXииииииииииЎ(Е
цииииииииииЎЕбЅЧиz~БЗЗбЅЕиииииииииии)Ж
цииииииииииЎЕд‘Зиz~БЗNLH^ООООООООООА)З
цииииииииииЎЕд‘Зиz~БЗNLH^ООООООООООА'И
цииииииииииЎ•дƒОЛ~ВЗNKJ^ООООООООООА&Й
цииииииииииЎ•д‘иz~БДдƒ•иииииииииии&К
цииииииииииЎµдƒиz~БДдіµиииииииииии#Л
цииииииииииЎµддЎЈЎддµиииииииииии#М
цииииииииииЎ≈дд»Ј»дд≈иииииииииии#Н
цииииииииииЎ’ддіЈдді’иииииииииии"О
цииииииииииЎедддддіеиииииииииии%П
цииииииииииЎеNNNNNHNQXииииииииииЎ#Р
цииииииииииЎе•ддддіе•иииииииииии#С
цииииииииииЎеµддддФеµиииииииииии"Т
цииииииииииЎеедддіееиииииииииии"У
цииииииииииЎе’ддд‘е’иииииииииии$Ф
цииииииииииЎе≈дддд^[^ООООООООООА#Х
цииииииииииЎеµддддФеµиииииииииии%Ц
цииииииииииЎеЕддддд^QXииииииииииЎ%Ч
цииииииииииЎеNNNNNHNQXииииииииииЎ#Ш
цииииииииииЎеддФ’ддФеиииииииииии%Щ
цииииииииииЎ’дд^Z^NAE≈иииииииииии$Ъ
цииииииииииЎ’д‘ееNLM^ООООООООООА#Ы
цииииииииииЎµд‘ееµд‘µиииииииииии#Ь
цииииииииииЎµдƒее’дƒµиииииииииии%Э
цииииииииииЎ•дƒеееNKJ^ООООООООООА%Ю
цииииииииииЎ•дƒеееNKJ^ООООООООООА$Я
цииииииииииЎХдƒеееХдƒХиииииииииии"†
циииииииииииииииииииииииииииии®"°
циииииииииииииииииииииииииииии®"Ґ
циииииииииииииииииииииииииииии®"£
циииииииииииииииииииииииииииии®"§
циииииииииииииииииииииииииииии®"•
циииииииииииииииииииииииииииии®"¶
циииииииииииииииииииииииииииии®"І
циииииииииииииииииииииииииииии®"®
циииииииииииииииииииииииииииии®"©
циииииииииииииииииииииииииииии®"™
циииииииииииииииииииииииииииии®"Ђ
циииииииииииииииииииииииииииии®"ђ
циииииииииииииииииииииииииииии®"≠
циииииииииииииииииииииииииииии®"Ѓ
циииииииииииииииииииииииииииии®"ѓ
циииииииииииииииииииииииииииии®"∞
циииииииииииииииииииииииииииии®"±
циииииииииииииииииииииииииииии®"≤
циииииииииииииииииииииииииииии®"≥
циииииииииииииииииииииииииииии®"і
циииииииииииииииииииииииииииии®"µ
циииииииииииииииииииииииииииии®"ґ
циииииииииииииииииииииииииииии®"Ј
циииииииииииииииииииииииииииии®"Є
циииииииииииииииииииииииииииии®"є
циииииииииииииииииииииииииииии®"Ї
циииииииииииииииииииииииииииии®"ї
циииииииииииииииииииииииииииии®"Љ
циииииииииииииииииииииииииииии®"љ
циииииииииииииииииииииииииииии®"Њ
циииииииииииииииииииииииииииии®"њ
циииииииииииииииииииииииииииии®"ј
циииииииииииииииииииииииииииии®"Ѕ
циииииииииииииииииииииииииииии®"¬
циииииииииииииииииииииииииииии®"√
циииииииииииииииииииииииииииии®"ƒ
циииииииииииииииииииииииииииии®"≈
циииииииииииииииииииииииииииии®"∆
циииииииииииииииииииииииииииии®"«
циииииииииииииииииииииииииииии®"»
циииииииииииииииииииииииииииии®"…
циииииииииииииииииииииииииииии®" 
циииииииииииииииииииииииииииии®"Ћ
циииииииииииииииииииииииииииии®"ћ
циииииииииииииииииииииииииииии®"Ќ
циииииииииииииииииииииииииииии®"ќ
циииииииииииииииииииииииииииии®"ѕ
циииииииииииииииииииииииииииии®"–
циииииииииииииииииииииииииииии®"—
циииииииииииииииииииииииииииии®"“
циииииииииииииииииииииииииииии®"”
циииииииииииииииииииииииииииии®"‘
циииииииииииииииииииииииииииии®"’
циииииииииииииииииииииииииииии®"÷
циииииииииииииииииииииииииииии®"„
циииииииииииииииииииииииииииии®"Ў
циииииииииииииииииииииииииииии®"ў
циииииииииииииииииииииииииииии®"Џ
циииииииииииииииииииииииииииии®"џ
циииииииииииииииииииииииииииии®"№
циииииииииииииииииииииииииииии®"Ё
циииииииииииииииииииииииииииии®"ё
циииииииииииииииииииииииииииии®"я
циииииииииииииииииииииииииииии®"а
циииииииииииииииииииииииииииии®"б
циииииииииииииииииииииииииииии®"в
циииииииииииииииииииииииииииии®"г
циииииииииииииииииииииииииииии®"д
циииииииииииииииииииииииииииии®"е
циииииииииииииииииииииииииииии®"ж
циииииииииииииииииииииииииииии®"з
циииииииииииииииииииииииииииии®"и
циииииииииииииииииииииииииииии®"й
циииииииииииииииииииииииииииии®"к
циииииииииииииииииииииииииииии®"л
циииииииииииииииииииииииииииии®"м
циииииииииииииииииииииииииииии®"н
циииииииииииииииииииииииииииии®"о
циииииииииииииииииииииииииииии®"п
циииииииииииииииииииииииииииии®"р
циииииииииииииииииииииииииииии®"с
циииииииииииииииииииииииииииии®"т
циииииииииииииииииииииииииииии®"у
циииииииииииииииииииииииииииии®"ф
циииииииииииииииииииииииииииии®"х
циииииииииииииииииииииииииииии®ЩЩЩ