BMAPBOLOv€2Аv€2ЙА€2Й€2oЗ€2vП€2ЗР€2ПЙ€2Рx€2Йp€2xo€2pv€2Бl€2l~€2УБ€2~У€2Б€ZZZ~€ZZZ~А€ZZZАБ€ZZZ|v€ZZZЙ|€ZZZГЙ€ZZZvГ€ZZZo|€ZZZГo€ZZZРГ€ZZZ|Р€ZZZАР€ZZZoА€ZZZР€ZZZo€ZZZjlУj
lХХУ"

цеееееееееееееееееееееееееееее•"
цеееееееееееееееееееееееееееее•"
цеееееееееееееееееееееееееееее•"
цеееееееееееееееееееееееееееее•"
цеееееееееееееееееееееееееееее•"
цеееееееееееееееееееееееееееее•"
цеееееееееееееееееееееееееееее•"
цеееееееееееееееееееееееееееее•"
цеееееееееееееееееееееееееееее•"
цеееееееееееееееееееееееееееее•"
цеееееееееееееееееееееееееееее•"
цеееееееееееееееееееееееееееее•"
цеееееееееееееееееееееееееееее•"
цеееееееееееееееееееееееееееее•"
цеееееееееееееееееееееееееееее•"
цеееееееееееееееееееееееееееее•"
цеееееееееееееееееееееееееееее•"
цеееееееееееееееееееееееееееее•"
цеееееееееееееееееееееееееееее•"
цеееееееееееееееееееееееееееее•"
цеееееееееееееееееееееееееееее•"
цеееееееееееееееееееееееееееее•" 
цеееееееееееееееееееееееееееее•"!
цеееееееееееееееееееееееееееее•""
цеееееееееееееееееееееееееееее•"#
цеееееееееееееееееееееееееееее•"$
цеееееееееееееееееееееееееееее•"%
цеееееееееееееееееееееееееееее•"&
цеееееееееееееееееееееееееееее•"'
цеееееееееееееееееееееееееееее•"(
цеееееееееееееееееееееееееееее•")
цеееееееееееееееееееееееееееее•"*
цеееееееееееееееееееееееееееее•"+
цеееееееееееееееееееееееееееее•",
цеееееееееееееееееееееееееееее•"-
цеееееееееееееееееееееееееееее•".
цеееееееееееееееееееееееееееее•"/
цеееееееееееееееееееееееееееее•"0
цеееееееееееееееееееееееееееее•"1
цеееееееееееееееееееееееееееее•"2
цеееееееееееееееееееееееееееее•"3
цеееееееееееееееееееееееееееее•"4
цеееееееееееееееееееееееееееее•"5
цеееееееееееееееееееееееееееее•"6
цеееееееееееееееееееееееееееее•"7
цеееееееееееееееееееееееееееее•"8
цеееееееееееееееееееееееееееее•"9
цеееееееееееееееееееееееееееее•":
цеееееееееееееееееееееееееееее•";
цеееееееееееееееееееееееееееее•"<
цеееееееееееееееееееееееееееее•"=
цеееееееееееееееееееееееееееее•">
цеееееееееееееееееееееееееееее•"?
цеееееееееееееееееееееееееееее•"@
цеееееееееееееееееееееееееееее•"A
цеееееееееееееееееееееееееееее•"B
цеееееееееееееееееееееееееееее•"C
цеееееееееееееееееееееееееееее•"D
цеееееееееееееееееееееееееееее•"E
цеееееееееееееееееееееееееееее•"F
цеееееееееееееееееееееееееееее•"G
цеееееееееееееееееееееееееееее•"H
цеееееееееееееееееееееееееееее•"I
цеееееееееееееееееееееееееееее•"J
цеееееееееееееееееееееееееееее•"K
цеееееееееееееееееееееееееееее•"L
цеееееееееееееееееееееееееееее•"M
цеееееееееееееееееееееееееееее•"N
цеееееееееееееееееееееееееееее•"O
цеееееееееееееееееееееееееееее•"P
цеееееееееееееееееееееееееееее•"Q
цеееееееееееееееееееееееееееее•"R
цеееееееееееееееееееееееееееее•"S
цеееееееееееееееееееееееееееее•"T
цеееееееееееееееееееееееееееее•"U
цеееееееееееееееееееееееееееее•"V
цеееееееееееееееееееееееееееее•"W
цеееееееееееееееееееееееееееее•"X
цеееееееееееееееееееееееееееее•"Y
цеееееееееееееееееееееееееееее•"Z
цеееееееееееееееееееееееееееее•"[
цеееееееееееееееееееееееееееее•"\
цеееееееееееееееееееееееееееее•"]
цеееееееееееееееееееееееееееее•"^
цеееееееееееееееееееееееееееее•"_
цеееееееееееееееееееееееееееее•"`
цеееееееееееееееееееееееееееее•"a
цеееееееееееееееееееееееееееее•"b
цеееееееееееееееееееееееееееее•"c
цеееееееееееееееееееееееееееее•"d
цеееееееееееееееееееееееееееее•"e
цеееееееееееееееееееееееееееее•"f
цеееееееееееееееееееееееееееее•"g
цеееееееееееееµааааеееееееееее’"h
цеееееееееееееµааааеееееееееее’"i
цеееееееееееµааааааеееееееееее’j
УеееееееееееµааРеееjФцРеееееееееее’(k
цеееееееееееµааРЕДзЧеАеееееееееее’l
jеееееееееееµРlkц^]YNz~QPАеееееееееее’%m
цеееееееееееµРБее§зЈ’Реееееееееее’(n
цеееееееееееµРеy~HAtƒЈ≈Реееееееееее’'o
цеееееееееееµР’Ід§NJ{Y^^^^^^^^^^]P(p
цеееееееееееµР≈ЧдƒNHIzY^^^^^^^^^^]P(q
цеееееееееееµРµЧ‘Х§Зµ‘ЧХРеееееееееее’-r
цеееееееееееµР•ЧƒХ TДЧД%ЕƒЗХРеееееееееее’/s
цеееееееееееµРХЧіХРAGЗФ	[HxY^^^^^^^^^^]P-t
цеееееееееееµРХЧ§ЕА≈З§µQTФЗЕРеееееееееее’0u
цеееееееееееµРЕЧ§ЕX[AtдЕQTФQPАеееееееееее’0v
цеееееееееееµРЕЧ§%LAtдSPTФQPАеееееееееее’-w
цеееееееееееµРxzJ^AtдД%IH[^^^^^^^^^^[P0x
цеееееееееееµРxzCPTіХ'TФЕ§Е TФЕ∞еееееееееееµ3y
цеееееееееееµРxyHRIISuHIZBPQTДЕ∞еееееееееееµ5z
цеееееееееееµРxyAP TДЕР%uЕД5IAP TД•Реееееееееееµ0{
цеееееееееееµРxyJYJUuХQTД•Ф•Реееееееееееµ0|
цеееееееееееµРxyATдEuTДNAPАеееееееееееµ.}
цеееееееееееµРxyATд5qu’ФNAPАеееееееееееµ*~
цеееееееееееµР}}HR~|}Bu^^^^^^^^^^[P/
цеееееееееееµРxyI{HQz{YI{HqPАеееееееееееµ0А
цеееееееееееµРqt§ЧФµЈЕQT§ЧФЧ^^^^^^^^^^[P*Б
цеееееееееееµР%tƒз„%LNqPАеееееееееееµ.В
цеееееееееееµРNATДеЗ5NATДЧ^^^^^^^^^^[P0Г
цеееееееееееµРNATДTuNATДЧ^^^^^^^^^^[P0Д
цеееееееееееµР•Ф•ФЕYUuХФ•ФЧ^^^^^^^^^^[P6Е
цеееееееееееµР•ФICPTXRuYAP TДЧ^^^^^^^^^^[P3Ж
цеееееееееееµ∞ЕФЕ TФХФЕ7PXZBPQTДЧ^^^^^^^^^^[P1З
цеееееееееееµ∞Е§%IHZBWX\CPTФЧ^^^^^^^^^^[P,И
цеееееееееееµ∞Е§Е TдДMJZIqPАеееееееееееµ/Й
цеееееееееее’РЕIBPQTд$tƒЕ TФЧЕРеееееееееееµ0К
цеееееееееее’РЕIHQNAt§ХQTФЧЕРеееееееееееµ-Л
цеееееееееее’РЕЗ§ЕZZI{XZIyY^^^^^^^^^^[P.М
цеееееееееее’РЕЗіХРHIxAPАХіЧХРеееееееееееµ.Н
цеееееееееее’РХЗƒХ TxyBPX\IzY^^^^^^^^^^[P(О
цеееееееееее’РХЧ‘µЗ§Х‘ЧµРеееееееееееµ(П
цеееееееееее’Р•ЧдФNKI|Y^^^^^^^^^^[P'Р
цеееееееееее’РµІд$tдФІ’Реееееееееееµ)С
цеееееееееее’Р≈Ј‘NAGЧе^^^^^^^^^^[P%Т
цеееееееееее’Р’зЈ§ееБРеееееееееееµУ
Хеееееееееее’Ре~yyN^PУЦцРеееееееееееµ(Ф
цеееееееееее’РБе~xxH^	^^^^^^^^^^[PХ
lеееееееееее’РХmц^^]^	^^^^^^^^^^[P"Ц
цеееееееееее’ааааааеееееееееееµ"Ч
цеееееееееее’ааааеееееееееееееµ"Ш
цеееееееееее’ааааеееееееееееееµ"Щ
цеееееееееееееееееееееееееееее•"Ъ
цеееееееееееееееееееееееееееее•"Ы
цеееееееееееееееееееееееееееее•"Ь
цеееееееееееееееееееееееееееее•"Э
цеееееееееееееееееееееееееееее•"Ю
цеееееееееееееееееееееееееееее•"Я
цеееееееееееееееееееееееееееее•"†
цеееееееееееееееееееееееееееее•"°
цеееееееееееееееееееееееееееее•"Ґ
цеееееееееееееееееееееееееееее•"£
цеееееееееееееееееееееееееееее•"§
цеееееееееееееееееееееееееееее•"•
цеееееееееееееееееееееееееееее•"¶
цеееееееееееееееееееееееееееее•"І
цеееееееееееееееееееееееееееее•"®
цеееееееееееееееееееееееееееее•"©
цеееееееееееееееееееееееееееее•"™
цеееееееееееееееееееееееееееее•"Ђ
цеееееееееееееееееееееееееееее•"ђ
цеееееееееееееееееееееееееееее•"≠
цеееееееееееееееееееееееееееее•"Ѓ
цеееееееееееееееееееееееееееее•"ѓ
цеееееееееееееееееееееееееееее•"∞
цеееееееееееееееееееееееееееее•"±
цеееееееееееееееееееееееееееее•"≤
цеееееееееееееееееееееееееееее•"≥
цеееееееееееееееееееееееееееее•"і
цеееееееееееееееееееееееееееее•"µ
цеееееееееееееееееееееееееееее•"ґ
цеееееееееееееееееееееееееееее•"Ј
цеееееееееееееееееееееееееееее•"Є
цеееееееееееееееееееееееееееее•"є
цеееееееееееееееееееееееееееее•"Ї
цеееееееееееееееееееееееееееее•"ї
цеееееееееееееееееееееееееееее•"Љ
цеееееееееееееееееееееееееееее•"љ
цеееееееееееееееееееееееееееее•"Њ
цеееееееееееееееееееееееееееее•"њ
цеееееееееееееееееееееееееееее•"ј
цеееееееееееееееееееееееееееее•"Ѕ
цеееееееееееееееееееееееееееее•"¬
цеееееееееееееееееееееееееееее•"√
цеееееееееееееееееееееееееееее•"ƒ
цеееееееееееееееееееееееееееее•"≈
цеееееееееееееееееееееееееееее•"∆
цеееееееееееееееееееееееееееее•"«
цеееееееееееееееееееееееееееее•"»
цеееееееееееееееееееееееееееее•"…
цеееееееееееееееееееееееееееее•" 
цеееееееееееееееееееееееееееее•"Ћ
цеееееееееееееееееееееееееееее•"ћ
цеееееееееееееееееееееееееееее•"Ќ
цеееееееееееееееееееееееееееее•"ќ
цеееееееееееееееееееееееееееее•"ѕ
цеееееееееееееееееееееееееееее•"–
цеееееееееееееееееееееееееееее•"—
цеееееееееееееееееееееееееееее•"“
цеееееееееееееееееееееееееееее•"”
цеееееееееееееееееееееееееееее•"‘
цеееееееееееееееееееееееееееее•"’
цеееееееееееееееееееееееееееее•"÷
цеееееееееееееееееееееееееееее•"„
цеееееееееееееееееееееееееееее•"Ў
цеееееееееееееееееееееееееееее•"ў
цеееееееееееееееееееееееееееее•"Џ
цеееееееееееееееееееееееееееее•"џ
цеееееееееееееееееееееееееееее•"№
цеееееееееееееееееееееееееееее•"Ё
цеееееееееееееееееееееееееееее•"ё
цеееееееееееееееееееееееееееее•"я
цеееееееееееееееееееееееееееее•"а
цеееееееееееееееееееееееееееее•"б
цеееееееееееееееееееееееееееее•"в
цеееееееееееееееееееееееееееее•"г
цеееееееееееееееееееееееееееее•"д
цеееееееееееееееееееееееееееее•"е
цеееееееееееееееееееееееееееее•"ж
цеееееееееееееееееееееееееееее•"з
цеееееееееееееееееееееееееееее•"и
цеееееееееееееееееееееееееееее•"й
цеееееееееееееееееееееееееееее•"к
цеееееееееееееееееееееееееееее•"л
цеееееееееееееееееееееееееееее•"м
цеееееееееееееееееееееееееееее•"н
цеееееееееееееееееееееееееееее•"о
цеееееееееееееееееееееееееееее•"п
цеееееееееееееееееееееееееееее•"р
цеееееееееееееееееееееееееееее•"с
цеееееееееееееееееееееееееееее•"т
цеееееееееееееееееееееееееееее•"у
цеееееееееееееееееееееееееееее•"ф
цеееееееееееееееееееееееееееее•"х
цеееееееееееееееееееееееееееее•ЩЩЩ